111111
1001N1
101001
110001
111111